G G G G G G G G G P P G G G G G G G G G
G G G G G G G G G P P G G G G G G G G G
G G G G G G G G G P P G G G G G G G G G
G G G G G G G G G P P G G G G G G G G G
G G G G G G G G G P P G G G G G G G G G
G G G G G G G G P P G G G G G G G G G G
G G G P P P P P P G G G G G G G G G G G
G G P P G G G G G G G G G G G G G G G G
G G P G G G W W G G G G G G G G G G G G
G G P G G W W W W W G G G G G G G G G G
G G P G G G W W W W W W W G G G G W W W
G G P G G G G W W W W W W W W W W W W W
G G P G G G G G G G G G G G W W G G G G
G G P P G G G G G G G G G G G G G G G G
G G G P P G G G G G G G G G G G G G G G
W G G G G G G G G G G G G G G G G G G G
W W W W W G G G G G G G G G G G G G G G
G G G G W W G G G G G G G G G G G G G G
G G G G G W W G G G P P P P P P G G G G
G G G G W W W G G G G G G G G P G G G G
G G G G W W W G G G G G G G G P P G G G
G G G G W W G G G G G G G G G G P G G G
G G G G G G G G G G G G G G G G P G G G
G G G P P G G G G G G G G G P P P G G G
G G P P P P P P P P P P P P P P G G G G
G G G P P P G G G G G G G G G G G G G G
G G G G G G G G G G G G G G G G G G G G
G G G G G G G G G G G G G G G G G G G G
